NO srcs/textures/f_no.xpm
SO srcs/textures/f_so.xpm
WE srcs/textures/f_we.xpm
EA srcs/textures/f_ea.xpm
CL srcs/textures/f_door.xpm
F 25,184,11
C 117,225,253
11111
10001
10N01
10001
11111
