NO srcs/textures/f_no.xpm
SO srcs/textures/f_so.xpm
WE srcs/textures/f_we.xpm
EA srcs/textures/f_ea.xpm
CL srcs/textures/f_door.xpm
F 25,184,11
C 117,225,253
1111111111111111111111111
1000000000110000000000001
1011000001110000000000001
10010000000000000000000011
111111111011000001110000011111111
100000000011000001110111111111111
11110111111111011100000010001
11110111111111011101010010001
11000000110100011100000010001
10000000000000001100000010001
10000S00000000001101010010001
1100000111010101111101111000111
11110111 1110101 101111010001
11111111 1111111 111111111111
