NO srcs/textures/f_no.xpm
SO srcs/textures/f_so.xpm
WE srcs/textures/f_we.xpm
EA srcs/textures/f_ea.xpm
CL srcs/textures/f_door.xpm
F 91,35,35
C 67,63,63
1111111111111111111111111
1000000000110000010100001
1011000001110000100010001
100100000000000000000001111111111
111111111011000000000000000000001
100000000011000000000111111111111
1111011111111011100000010001
1111C111111110111010100100011
11000000110100011100000010001
10000000000000001100000010001
100S0000000000001101010010001
1100000111010101111101111000111
11110111 1110101 101111010001
11111111 1111111 111111111111
